1111111111111
10010000000C1
1000011111011
1P0011E000001
1001100010001
1000100C10E01
1000011010001
10000000C0001
1111111111111

