1111111111111
11110000000C1
1100011111011
1P0010E010001
1001101110001
1000100C10001
1000001010001
10000001C0001
1111111111110

